############################
#............##............#
#.####.#####.##.#####.####.#
#.####.#####.##.#####.####.#
#..........................#
#.####.##.########.##.####.#
#......##....##....##......#
######.#####.##.#####.######
#..........................#
#..........######..........#
#.######...####....######..#
#..........................#
#.####.##.########.##.####.#
#.####.##....##....##.####.#
#......######.##.######....#
#..........................#
#.####.#####.##.#####.####.#
#............##............#
#............##............#
############################
